5.ox
.........o
....oo....
........o.
..........
oo........
